Neu! - Neu!
Kraftwerk - Autobahn
Jean Michel Jarre - Oxygen
Brian Eno - Ambient 1 - Music For Airports
New Order - Movement
Techno - The New Dance Sound of Detroit
KLF - White Room
The Orb - Adventures Beyond the Ultraworld
Orbital - Orbital
Massive Attack - Blue Lines
Primal Scream - Screamadelica
Prodigy - Jilted Generation
Underworld - dubnobasswithmyheadman
Leftfield - Leftism
Chemical Brothers - Exit Planet Dust
Goldie - Timeless
DJ Shadow - Entroducing
Sasha & Digweed - Northern Exposure
Roni Size Reprezant - New Forms
Daft Punk - Homework
Boards of Canada - Music Has the Right to Children
Air - Moon Safari
Fat Boy Slim - You’ve Come A Long Way Baby
Basement Jaxx - Remedy
Moby - Play
Avalanches - Since I Left You
Daft Punk - Discovery
2 Many Djs - As Heard on Radio Soulwax Pt2
Soulwax - Nite Versions
M.I.A - Arular
Burial - Burial
Skream - Skream!
LCD Soundsystem - Sound of Silver
Klaxons - Myths of the Near Future
Justice - Cross
Crystal Castles - Crystal Castles
Major Lazer - Guns Don’t Kill People… Lasers Do
Deadmau5 - Random Album Title
Four Tet - There Is Love in You
James Blake - James Blake
Nicolas Jaar - Space Is Only A Noise
Chase & Status - No More Idols
Skrillex - Bangarang EP
Flume - Flume
Disclosure - Settle
Stromae - Racine Carrée
Fischerspooner - Odyssey